6 5 5 5 5 5 5 5 5 7
2 8 8 8 9 9 9 8 9 4
2 8 9 9 9 9 9 8 8 4
2 8 9 10 9 9 9 9 9 4
2 9 9 9 9 9 9 9 9 4
2 9 8 8 8 8 9 9 9 4
2 9 9 9 9 9 9 9 9 4
2 9 9 9 10 9 9 9 9 4
2 9 9 9 9 9 9 9 9 4
1 3 3 3 3 3 3 3 3 0