11 11 12 88 87
6  1 5 1 5 1 5 1 5 1 11 1 5 1 5 1 5 1 5 1 7 1
2  1 8 1 8 1 8 1 9 0  9 0 9 0 8 1 8 1 8 1 4 1
2  1 8 1 9 0 9 0 9 0  9 0 9 0 8 1 8 1 8 1 4 1
2  1 8 1 9 0 9 0 9 0  9 0 9 0 9 0 9 0 9 0 4 1
2  1 8 1 9 0 9 0 9 0  9 0 9 0 9 0 9 0 9 0 4 1
11  1 9 0 9 0 9 0 9 0  9 0 9 0 9 0 9 0 9 0 11 1
2 1 9 0 9 0 9 0 9 0  9 0 9 0 9 0 9 0 9 0 4 1
2  1 9 0 9 0 9 0 9 0  9 0 9 0 9 0 9 0 9 0 4 1
2  1 9 0 8 1 9 0 9 0  9 0 9 0 9 0 9 0 9 0 4 1
2  1 9 0 9 0 9 0 9 0  9 0 9 0 9 0 9 0 9 0 4 1
1  1 3 1 3 1 3 1 3 1  3 1 3 1 3 1 3 1 3 1 0 1